1,1,1,1,1,1,1,1,1,1,1,1,1,1,1,1,1,1,1,1,1,1,1,1,1,1,1,1,1,1
1,5,2,2,2,2,2,2,2,2,2,2,2,2,1,1,2,2,2,2,2,2,2,2,2,2,2,2,5,1
1,2,1,1,1,1,2,1,1,1,1,1,1,2,1,1,2,1,1,1,1,1,1,2,1,1,1,1,2,1
1,2,1,1,1,1,2,1,1,1,1,1,1,2,1,1,2,1,1,1,1,1,1,2,1,1,1,1,2,1
1,2,2,2,2,2,2,2,2,2,2,2,2,2,2,2,2,2,2,2,2,2,2,2,2,2,2,2,2,1
1,2,1,1,1,1,2,1,1,1,1,1,1,1,1,1,1,1,1,1,1,1,1,2,1,1,1,1,2,1
1,2,2,2,2,2,2,2,2,2,2,2,2,2,2,2,2,2,2,2,2,2,2,2,2,2,2,2,2,1
1,2,1,1,1,1,1,1,1,1,1,1,1,1,1,2,1,1,1,1,1,1,1,1,1,1,1,1,2,1
1,2,1,1,1,1,1,1,1,2,1,1,1,2,2,2,2,1,1,1,2,1,1,1,1,1,1,1,2,1
1,2,1,1,2,2,2,2,2,2,1,1,1,2,1,1,2,1,1,1,2,2,2,2,2,2,1,1,2,1
1,2,1,1,2,1,1,1,1,2,2,2,2,2,1,1,2,2,2,2,2,1,1,1,1,2,1,1,2,1
1,2,2,2,2,1,1,1,1,1,2,1,1,1,1,1,1,1,1,0,1,1,1,1,1,2,2,2,2,1
1,2,1,1,1,1,1,2,2,2,2,2,2,2,2,2,2,2,2,2,2,2,2,1,1,1,1,1,2,1
1,5,2,2,1,2,2,2,1,2,1,1,1,1,0,1,1,1,1,1,2,1,2,2,2,1,2,2,2,1
1,2,1,2,1,2,1,2,1,2,1,3,0,0,3,0,0,3,0,1,2,1,2,1,2,1,2,1,2,1
1,2,1,2,1,2,1,2,1,2,1,0,1,1,1,1,1,1,0,1,2,1,2,1,2,1,2,1,2,1
1,2,1,2,1,2,1,2,1,2,1,0,3,0,0,3,0,0,3,1,2,1,2,1,2,1,2,1,2,1
1,2,1,2,1,2,1,2,1,2,1,1,1,1,1,1,1,1,1,1,2,1,2,1,2,1,2,1,2,1
1,2,1,2,2,2,2,2,2,2,2,2,2,2,2,2,2,2,2,2,2,2,2,2,2,2,2,1,2,1
1,2,1,1,1,1,1,1,1,1,1,1,2,1,1,1,1,2,1,1,1,1,1,1,1,1,1,1,2,1
1,2,2,2,2,2,1,1,1,2,2,2,2,1,1,1,1,2,2,2,2,1,1,1,2,2,2,2,5,1
1,2,1,1,1,2,1,1,1,2,1,1,2,1,1,1,1,2,1,1,2,1,1,1,2,1,1,1,2,1
1,2,1,1,1,2,2,2,2,2,2,2,2,1,1,1,1,2,2,2,2,2,2,2,2,1,1,1,2,1
1,2,1,1,1,2,1,1,1,1,1,1,2,1,1,1,1,2,1,1,1,1,1,1,2,1,1,1,2,1
1,2,2,2,2,2,2,2,2,2,2,2,2,1,1,1,1,2,2,2,2,2,2,2,2,2,2,2,2,1
1,2,1,1,1,1,1,1,1,1,1,1,2,1,1,1,1,2,1,1,1,1,1,1,1,1,1,1,2,1
1,2,1,1,1,1,1,1,1,1,1,1,2,1,1,1,1,2,1,1,1,1,1,1,1,1,1,1,2,1
1,2,1,1,1,1,1,1,1,1,1,1,2,1,1,1,1,2,1,1,1,1,1,1,1,1,1,1,2,1
1,5,2,2,2,2,2,2,2,2,2,2,2,0,4,0,2,2,2,2,2,5,2,2,2,2,2,2,2,1
1,1,1,1,1,1,1,1,1,1,1,1,1,1,1,1,1,1,1,1,1,1,1,1,1,1,1,1,1,1